0 1 1 1 1 1 1 1 1 1
1 1 1 0 0 0 4 0 0 0
2 1 1 0 1 0 1 0 1 0
0 1 3 1 4 0 0 0 4 0
6 1 1 6 1 1 1 1 1 0
0 1 1 0 1 1 0 0 0 6
5 1 1 1 1 1 0 1 1 1
0 1 0 0 6 1 0 0 0 1
0 1 0 1 1 1 1 1 0 1
0 6 1 1 0 0 0 0 0 1
