0 1 1 1 1 1 1 1 1 1
0 1 1 0 0 0 4 0 0 0
2 1 1 0 1 0 1 0 1 0
0 3 3 0 4 0 0 0 4 0
0 1 1 0 1 1 1 1 1 0
0 0 0 0 3 4 0 0 0 6
5 1 1 1 1 1 0 1 1 1
0 1 4 0 6 1 0 0 0 1
0 1 4 1 0 1 1 1 0 1
0 4 4 1 0 0 0 0 0 1
